NO textures/matrix.png
SO textures/matrix.png
WE                      textures/matrix.png
EA textures/matrix.png


F 0,0,0
C 0,0,0


1111111111111111111111
1011111111111111111111
101000001000000000001
101010101011111110001
10001010001000001000111
1111101011111010111000111
10000010100010100000001
101111101011101111111111111
101000001010100000101
101011111010111110101
10101000101010001101
1011W0101010101010101
100000101010001010001
111111101011111011101
100000101000100010001
101110101110101110111
101000100000100010101
101011111111111010101
111111111111111111111








