NO textures/matrix.png
SO                               textures/matrix.png
WE                      textures/matrix.png
EA textures/matrix.png


F 0,0,0
C 0,0,0


111111111111111111111
101000001000000000001
101010101011111110001
100010100010000010001
111110101111101011101
100000101000101000001
101111101011101111111
101000001010100000101
101011111010111110101
101010001010100011011
101100101010101010101
100000101110001010001
101111101011111011101
100000101000100010001
101110101110101110111
101000100000100010101
1N1011111111111010101
111111111111111111111





