NO textures/wave.png
WE textures/watermelon.png
SO textures/wall.png
EA textures/starry_night.png

C 237,59,66
F 80,190,106

 1111111        111111111
110000011      10000000001
100000001     1000000000001
 1000001     100000000000001
  11011      1000000000000001
   101        1000000100000001
   101         1000010100000001
   101111111111100000100000001
   100000000000000000000000001
   101111111111100000000000001
   101         10000000000111
   101        1000000000001
  11011      1000000000011
 1000001     1000000N0001
100000001     10000000001
110000011      1000000001
 1111111        111111111









 
